  R 720 480

      NO       ./textures/greystone.xpm


  SO ./textures/bluestone.xpm

  WE  ./textures/colorstone.xpm
EA ./textures/redbrick.xpm


S  ./textures/pillar.xpm

F 	-0, 255 ,255

    C 225,30, 0


 1111111111111111111111111111
111000002000110001111202001
1011000001020000000000111111
1001000000000000011100001111111111
111111111011000001110000000000001
100000000011000001110111111111111
11110111111111011100000010001
111101111111111111111111111111
120000000000000000000000000001
100002000000000020000000020001
100000000000000000000000000001
110000001100000000200002220001
101000001000020001000000000001
100100001000000000100000000001
10001000000N000000010000000001
100021000000000011001000100011
100001111110000000000100000001
100000000001000000000002000001
100000000002201000000000000001
100002000000000200002000000001
100000000000000000000000000001
102000000000000000020000000001
110000011101012111110111100101
111121111101010111011110100111
111111111111111111111111111111


