
    
	R 1200 700 

  NO    ./textures/mossy.xpm
  SO ./textures/bluestone.xpm
  WE ./textures/colorstone.xpm



 EA ./textures/redbrick.xpm
S  ./textures/barrel.xpm

        F   	./textures/greystone.xpm
C  ./textures/wood.xpm
W  ./textures/weapon.xpm

1111111111111111
111111111111111111111111
100000011110000000000001
1011000001020000020000011
1001000000000000000000001111111111
111111111011000001110000000000001
100000000011000001110111111111111
11110111111111011100000010001
111101111111111111111111111111
10000000000000000000000000002111
1000000000022200000000000000011
10000000000000000000000000000111
1100000000020000100001111111001
101000000000000000001111111111111
10010000000000111111000011100211
1100010000000000000000000000001
1000210000000000110000001000111
1000000000N0000000000000000001
100000000000002200000000000001
100000002220000000000000000021
100000000000000001111000000001
100000000000000000001111000001
100000000000000020000000000001
110000011101010111110111100111
11110111111101011101111110011
111111111011111111111111111111
11111111111
1
